<0
0,1,1,1,1,1,1,80,80,1,1,1,1,1,1,0,0,0,
1,1,0,0,0,0,0,0,0,0,0,0,0,0,1,1,
1,0,0,0,0,0,0,0,0,0,0,0,0,0,0,1,
1,0,0,0,0,0,0,0,0,0,0,0,0,0,0,1,
1,0,0,0,0,0,0,0,0,0,0,0,0,0,0,1,
1,0,0,0,0,0,0,0,74,0,0,0,0,0,0,1,
1,0,0,0,0,0,0,0,0,0,0,0,0,0,0,1,
1,0,0,0,0,0,0,0,0,0,0,0,0,0,0,1,
1,0,0,0,0,0,0,0,0,0,0,0,0,0,0,1,
1,0,0,0,0,0,0,0,0,0,0,0,0,0,0,1,
1,1,0,0,0,0,0,0,0,0,0,0,0,0,1,1,
0,1,1,1,1,1,0,0,0,0,1,1,1,1,1,0,
0,0,0,0,0,1,1,0,0,1,1,
0,0,0,0,0,0,1,0,0,1,
0,0,0,0,0,0,1,0,0,1,
0,0,0,0,0,0,1,0,0,1,
0,0,0,0,0,0,1,0,0,1,
0,0,0,0,0,0,1,0,0,1,
0,0,0,0,0,0,1,0,0,1,
0,0,0,0,0,0,1,0,0,1,
0,0,0,0,0,0,1,0,0,1,
0,0,0,0,0,0,1,0,0,1,
0,0,0,0,0,0,1,0,0,1,
0,0,0,0,0,0,1,0,0,1,
0,0,0,0,0,0,1,0,0,1,
0,0,0,0,0,0,1,0,0,1,
0,0,0,0,0,0,1,0,0,1,
0,0,0,0,0,0,1,0,0,1,
0,0,0,0,0,0,1,0,0,1,
0,0,0,0,0,0,1,0,0,1,
0,0,0,0,0,0,1,0,0,1,
0,0,0,0,0,0,1,0,0,1,
0,0,0,0,0,0,1,0,0,1,
0,0,0,0,0,0,1,0,0,1,
0,0,0,0,0,0,1,0,0,1,
0,0,0,0,0,0,1,69,0,1,
0,0,0,0,0,0,1,1,1,1,-

<1
-

<2
-

<3
-

EOF