<0
71,



0,0,0,0,0,70,70,70,70,70,70,
0,0,0,0,0,70,70,0,0,70,70,
0,0,0,0,0,70,70,0,0,70,70,
70,70,70,70,70,70,70,0,0,70,70,70,70,70,70,70,
70,0,0,0,0,0,0,0,0,0,0,0,0,0,0,70,
70,0,0,0,0,0,0,0,0,0,0,0,0,0,0,70,
70,0,0,0,0,0,0,0,0,0,0,0,0,0,0,70,
70,0,0,0,0,0,0,0,0,0,0,0,0,0,0,70,
70,0,0,0,0,0,0,0,0,0,0,0,0,0,0,70,
70,0,0,0,0,0,0,0,0,0,0,0,0,0,0,70,
70,0,0,0,0,0,0,0,0,0,0,0,0,0,0,70,
70,0,0,0,0,0,0,0,0,0,0,0,0,0,0,70,
70,0,0,0,0,0,0,0,0,0,0,0,0,0,0,70,
70,0,0,0,0,0,0,0,0,0,0,0,0,0,0,70,
70,0,0,0,0,0,0,0,0,0,0,0,0,0,0,70,
70,0,0,0,0,0,0,0,69,0,0,0,0,0,0,70,
70,0,0,0,0,0,0,0,0,0,0,0,0,0,0,70,
70,0,0,0,0,0,0,0,0,0,0,0,0,0,0,70,
70,70,70,70,70,70,70,70,70,70,70,70,70,70,70,70,-

<1
-

<2
-

<3
-

EOF