<0
71,



0,0,0,0,0,70,70,70,70,70,70,
0,0,0,0,0,70,70,76,76,70,70,
0,0,0,0,0,70,70,0,0,70,70,
0,0,0,0,0,70,70,0,0,70,70,
0,0,0,0,0,70,0,0,0,0,70,
0,0,0,0,0,70,0,0,0,0,70,
0,0,0,0,0,70,0,0,0,0,70,
0,0,0,0,0,70,0,0,0,0,70,
0,0,0,0,0,70,0,0,0,0,70,
0,0,0,0,0,70,0,0,0,0,70,
0,0,0,0,0,70,0,0,0,0,70,
0,0,0,0,0,70,0,0,0,0,70,
0,0,0,0,0,70,0,0,0,0,70,
0,0,0,0,0,70,78,78,78,78,70,
0,0,0,0,0,70,0,0,0,0,70,
0,0,0,0,0,70,0,0,0,0,70,
0,0,0,0,0,70,0,0,0,0,70,
0,0,0,0,0,70,0,73,69,0,70,
0,0,0,0,0,70,0,0,0,0,70,
0,0,0,0,0,0,70,70,70,70,-

<1
-

<2
-

<3
-

EOF