4,4,4,4,4,4,4,4,4,4,4,4,4,4,4,4,
2,0,0,0,0,0,0,0,0,0,0,0,0,0,0,3,
2,0,0,0,0,0,0,0,0,0,0,0,0,0,0,3,
2,0,0,0,0,69,0,0,0,0,0,0,0,0,0,3,
2,0,0,0,0,0,0,0,0,0,0,0,0,0,0,3,
2,0,0,0,0,0,0,0,0,0,1,0,0,0,0,3,
2,0,0,0,0,0,0,0,0,0,0,0,0,0,0,3,
2,0,0,0,0,0,0,0,0,0,0,0,0,0,0,3,
2,0,0,0,0,0,0,0,0,7,0,0,0,0,0,3,
2,0,0,0,0,0,0,0,0,0,0,0,0,0,0,3,
2,0,0,0,0,0,0,0,0,0,0,0,0,0,0,3,
1,1,1,1,1,1,1,1,1,1,1,1,1,1,1,1-