<0
22,

0,70,70,70,70,70,70,70,70,70,70,70,70,
70,70,70,0,0,0,0,0,0,0,0,0,70,70,70,
70,0,0,0,0,0,0,0,0,0,0,0,0,0,70,0,0,0,0,0,0,0,0,0,0,0,0,0,70,70,70,70,70,70,
70,0,0,0,0,0,0,0,0,0,0,0,0,0,70,0,0,0,0,0,0,0,0,0,0,0,0,70,70,70,0,0,70,70,
70,0,0,0,0,0,0,0,0,0,0,0,0,0,70,0,0,0,0,0,0,0,0,0,0,0,70,70,70,70,0,0,70,70,
70,0,0,0,0,0,0,0,0,0,0,0,0,0,70,70,70,70,70,70,70,70,70,70,70,70,70,70,70,70,0,0,70,70,70,
70,0,0,0,0,0,0,0,0,0,0,0,0,0,0,0,0,0,0,0,0,0,0,0,0,0,0,0,0,0,0,0,0,70,70,
70,70,0,0,0,0,0,0,0,0,0,0,0,0,0,0,0,0,0,0,0,0,0,0,0,0,0,0,0,0,0,0,0,70,70,
0,70,70,0,0,0,0,0,0,0,0,0,70,70,70,70,70,70,70,70,70,70,70,70,70,70,70,70,70,70,70,70,70,70,70,
0,0,70,70,0,0,0,0,0,0,0,70,70,70,70,
0,0,0,70,70,70,70,70,70,70,70,70,70,
0,
70,70,70,70,70,70,70,70,70,70,70,70,70,70,70,70,70,-

<1




0,0,0,0,0,0,0,0,69,-

<2
-

<3
-

EOF