<0
22,

0,70,70,70,70,70,70,70,70,70,70,70,70,
70,70,70,0,0,0,0,0,0,0,0,0,70,70,70,
70,0,0,0,0,0,0,0,0,0,0,0,0,0,70,0,0,0,0,0,0,0,0,0,0,0,0,0,70,70,70,70,70,70,
70,0,0,0,0,0,0,0,0,0,0,0,0,0,70,0,0,0,0,0,0,0,0,0,0,0,0,70,70,72,72,72,70,70,
70,0,0,0,0,0,0,75,0,0,0,0,0,0,70,0,0,0,0,0,0,0,0,0,0,0,70,70,70,70,0,0,70,70,
70,0,0,0,0,0,0,69,0,0,0,0,0,0,70,70,70,70,70,70,70,70,70,70,70,70,70,70,70,70,0,0,70,70,70,
70,0,0,0,0,0,0,0,0,0,0,0,0,0,0,0,0,0,0,0,0,0,0,0,0,0,0,0,0,0,0,0,0,70,70,
70,70,0,0,0,0,0,0,0,0,0,0,0,0,0,0,0,0,0,0,0,0,0,0,0,0,0,0,0,0,0,0,0,70,70,
0,70,70,0,0,0,0,0,0,0,0,0,70,70,70,70,70,70,70,70,70,70,70,70,70,70,70,70,70,70,70,70,70,70,70,
0,0,70,70,0,0,0,0,0,0,0,70,70,70,70,
0,0,0,70,70,70,70,70,70,70,70,70,70,
0,70,70,70,70,70,70,70,70,70,70,70,70,70,70,-

<1
-

<2
-

<3
-

EOF